10 10 0 0 9 3
G S G S G G G G S S
G G G G G S G G G S
G S S S S S S S S S
G G G G G G G S G M
S G S S S S G S G S
S G S S S S G S G S
S G G G S S G S G S
G G S G S S G S G S
G S S G G S G G G S
G G S G S S G S S S

