14 14 2 3 13 9
G G S G G G G G S G G G W I
G S G G S G G G G G S G W W
G G S G G G W W W W G G G G
G G G S G G S G G G G S G M
G S G G G G G G S G G G S G
G G G G G G G S G G G S G S
G S G G G G S W W W W W G G
G S G G G G G W W W W W G G
G S G S G S G W W W W W G G
G S G G S G S G G G G G G M
G S G G S S G G G S G G G G
G S G G G G W W W G G G G G
G S S S G G G G S G G S G G
G G G G G G S G G G W W W W
